46
1111111111101111100000000000000000011100000000
1001111010010111011101010000101111110111110000
0001000010010000000010111101111011101101011000
0011111111110001001001110100100111111100001000
0101001011010000101010010001000000001100101010
0101000100011011110100010100001000010110001010
0011000011011010100100100100101001100010001000
0101001111111001010000111100010011111110001010
0000101110010000000001001100001010000010100000
1010001110000011010100001010000100011000001010
0010001110000011110000100000001000010100000100
1001110111100001100001110100001000000101010010
0000011001111111111011111110010000101011000010
1001000010101011010001001000111000010001100000
0100010011100000000001100110000110011001000000
1100001000000111010010000000000011000000100000
0000111001010100100101000100001101100001000000
1001010010000001110100110010000100100001001010
0011001000000000000000001000000100100111000000
0000001010100100100001000001001000101001000010
1001101100010010000100011000001000110000000000
0100010101011000011011001001000111100101000000
1000000001101300000000110001100001000001001010
1001011010101000010100100100104000101001100000
1000111011000001001000001000000101100100000000
1000001011011010101101110010000001001001010000
0101010010010000010000000101011110010000100100
1000000000010001001000101010001111000011000100
0101110010110100100001111000011110111001000010
0001010000000001001000111011010011010000010000
1100011000100111100100111100000001110000100100
1000011000110000111011100010000010101000000110
0000001100000000011100100000000101001000000010
0000000001000011010101001100000010100010111000
0110011100101001010110000100000110100101000100
0010010011000000001110000100100010100010010000
1100010100000001000010000001000010011000100000
1110011001000100000010000010000110100100010000
0111110000100110010100001100000001101011010000
0100110000000000000010011100001111011100100011
0001111100010010011001111011110100101010101111
0001101010111010010001111010000000010000010000
0001100010001110000111110000000010110000110000
0000011111000000001100000000000000000010100000
0000010000000101000001000000100010000100000000
1100010110011100100011001010010100001110010000
