32
00000000000000000000000000000000
00000000000000000000000000000000
00000000000000000000000000000000
00000000000000000000000000000000
00000111111000000111110000000000
00000000001000000100010000000000
00000000001100001000011000000000
00000000000100001000001000000000
00000000000100001000001000000000
00000000111100000000001000000000
00000000011000000000001000000000
00000000000100000000001000000000
00000000000110000000001000000000
00000000000010000000001000000000
00000000000010000000010000000000
00000000000010000000010000000000
00000000000110000000100000000000
00000001000100000001000000000000
00000001111000000010111110000000
00000000110000000000000000000000
00000000000000000000000000000000
00000000000000000000000000000000
00000000000000000000000000000000
00000000000000000000000000000000
00000000000000000000000000000000
00000000000000000000000000000000
00000000000000000000000000000000
00000000000000000000000000000000
00000000000000000000000000000000
00000000000000000000000000000000
00000000000000000000000000000000
00000000000000000000000000000000
