46
4000000000000002220000000000000220000000000003
1111111111111111111111111111111111111111111110
3000000000000002220000000000000220000000000003
0111111111111111111111111111111111111111111111
3000000000000002220000000000000220000000000003
1111111111111111111111111111111111111111111110
3000000000000002220000000000000220000000000003
0111111111111111111111111111111111111111111111
3000000000000002220000000000000220000000000003
1111111111111111111111111111111111111111111110
3000000000000002220000000000000220000000000003
0111111111111111111111111111111111111111111111
3000000000000002220000000000000220000000000003
1111111111111111111111111111111111111111111110
3000000000000002220000000000000220000000000003
0111111111111111111111111111111111111111111111
3000000000000002220000000000000220000000000003
1111111111111111111111111111111111111111111110
3000000000000002220000000000000220000000000003
0111111111111111111111111111111111111111111111
3000000000000002220000000000000220000000000003
1111111111111111111111111111111111111111111110
3000000000000002220000000000000220000000000003
0111111111111111111111111111111111111111111111
3000000000000002220000000000000220000000000003
1111111111111111111111111111111111111111111110
3000000000000002220000000000000220000000000003
0111111111111111111111111111111111111111111111
3000000000000002220000000000000220000000000003
1111111111111111111111111111111111111111111110
3000000000000002220000000000000220000000000003
0111111111111111111111111111111111111111111111
3000000000000002220000000000000220000000000003
1111111111111111111111111111111111111111111110
3000000000000002220000000000000220000000000003
0111111111111111111111111111111111111111111111
3000000000000002220000000000000220000000000003
1111111111111111111111111111111111111111111110
3000000000000002220000000000000220000000000003
0111111111111111111111111111111111111111111111
3000000000000002220000000000000220000000000003
1111111111111111111111111111111111111111111110
3000000000000002220000000000000220000000000003
0111111111111111111111111111111111111111111111
3000000000000002220000000000000220000000000000
1111111111111111111111111111111111111111111111
