16
0000000000000000
0000000000000000
0030011111100300
0000000000000000
0000000000000000
0010010000100100
0010000000000100
0010000400000100
0010000000000100
0010000000000100
0010010000100100
0000000000000000
0000000000000000
0030011111100300
0000000000000000
0000000000000000
