32
30000000000000000000000010000003
00000220000002222222220000000000
00002200000000020022222202200100
01002110010002200000000220020000
00002000222222000001100000002200
00002002202202222202000001000220
00002220220002000000220000000022
00222222200011000000002000000002
00202100000120000000000000003002
02001000001020022202120000000002
02010030000020020000002000000002
01000000000020021200001200101002
01000000000020201002210022000122
00000022222220200000200022000221
00100220000002222000020002000200
00110200120220242000020011200220
22000200220000222000102002200020
02000220200000000002222222020000
02000020202202001002000000021000
02000120220000022112000100022100
01200112222220002202000001000210
01200000000011000212000000000220
01020000100012001212000000000020
00002200000002200002010030000120
00000000300002200002000000001020
00000000010002000002010000000020
00200000000000200020000222000220
00201000000000222220002200222200
00022010010010000000002001001201
00000200000010000000221000022000
00000002222222222222200000200000
30000000000000000000000000000003
