46
0000000000010000000200000000000010000000100000
0000000020000000000000000010200000000020000000
0000000200000000000000010000000000000000000000
0000000000000000000000000000000000000000100000
0000000200000002000000000000000010000000000000
0000000000000000200000100000000000000000002000
0000000000002000100100200000010000000000000000
0000000002000000020010000010100101020000000000
0000000000020000000000200000200000100000010000
0001000200020000000020020002000000100000001000
0000000120000000000000000000000010010010000000
0000001200000100010000010000000200110000000000
0010000100000100120010100100001000000020000002
0000002010100100000000000000000002100200010000
0000000200001000100100210020000000021000000000
0100000210000000002000100000000000020000000100
0000000000100100000000202020200000000000101002
0000002000010120200000000020020100000200200000
0000000000001001000002222220010000000100020000
0000000200000000000010000100000000100200001000
0100002000000000000020000000200000001200000000
0000100010100000000000000000000000000000000002
0000020000010000000022000000200000100000200200
0000020200000020000000202020000010002000100000
0000000200002000000000000000000000000201000000
0010001000000020000200202000000000000000000000
0000012020000000000000000020001000200000000002
0001020000010000200000000002000000002200000200
0000010102000002000000001020002000001100000000
0000000020000020020020020200000000000000000000
0000100000002100100000000000000000020000000002
0000102002020022000000002100000210000000000000
0000000000002000022002000020000010000000000000
0000111100000001000000000000000002000000200000
0000000200002000011000000010000000000000000000
0000000010022000000000000000011001000400000000
0000100010000000000000000000010000000000000200
0000001002000000000000000000200000000000000000
0000000000001200200000010001000000020000000000
0000000000021000010000100000000000000000000000
0000000000100020010020020000002000000000000000
0000010000000000020000000200100000000002000000
0000000000000000200000000000000000000000000000
0000000000000000000000000000000000000000000000
0000000001000000000200000000000000020000000000
0000000000000000000000000000000000000000000000
