32
00000000000000000000000000000000
00000000000000000000000000000000
00000000000000000000000000000000
00000000000000003303000000000000
00004000000000003000030300000000
00000400000000000000000000000000
00000040000000003000000000000000
00000004000000000000000000000000
00000000400000003000040000000000
00000000000000000000040000000000
00000000000400040004040000000000
00000000000400000000040000000000
00000000400000004300000000000000
00000004000000000000040004400000
00000000000000000000000000440000
00000040000000000003000000040000
00000400003000000000000000040000
00000400003000000000000000000000
00000000000300000000300000040000
00000400000000000000030000000000
00000000000300000000330000040000
00000400000030000000000000000000
00000040000003000033000004440000
00000000040040334300400440000000
00000000000000000000000000000000
00000000000000000000000000000000
00000000000000000000000000000000
00000000000000000000000000000000
00000000000000000000000000000000
00000000000000000000000000000000
00000000000000000000000000000000
00000000000000000000000000000000
