16
1111111111111111
1000000000000001
1000001000000001
1000000000222001
1000100000222001
1001110000222001
1000100000222001
1000000000222001
1000100400222301
1000100000222001
1000100000222001
1000000000222001
1000011000000001
1000001000000001
1000000000000001
1111111111111111
