16
0000000000000000
0000000000000000
0000000000000000
0000000000000000
0000000000000000
0000000000000000
0040000000000000
0000000000000000
2222222222222222
2222222222222222
2222222222222222
2222222222222222
2222222222222222
2222222222222222
2222222222222222
2222222222222223
