16
0000000000000000
0000000000000000
0000000000000000
0000000000000000
0000000200000000
0000022222220000
0000022222220000
0000222222220000
0000222422220000
0000222222220000
0000022222200000
0000000000000000
0000000000000000
0000000000000000
0000000000000000
0000000000000000
