16
3232323232323232
2323232323232323
3232323232323232
2323232323232323
3232323232323232
2323232323232323
3232323232323232
2323232423232323
3232323232323232
2323232323232323
3232323232323232
2323232323232323
3232323232323232
2323232323232323
3232323232323232
2323232323232323
